C 122,202,199
F 114,85,68

SO	      			./_texture/SO.xpm
NO ./_texture/NO.xpm
WE ./_texture/WE.xpm
EA					./_texture/EA.xpm
                                         
11111111111111
100000000000001
10000111111111111111111111
10000011000000000000010001
10000010000000000000000001
10N00011000000000000010001
11100000011011111111110001
110000000000001      10001
100000000000001      10001
100000000000001      10001
10000001000000111111111111111111111
10000000000000000000000000000000001
100000000000001000000000000000000011111
110000000000001001100000000000110010001
111111111111111111111111111111111111111