C 0,191,255
F 0,128,0

        SO	      			./_texture/path_to_the_south_texture
NO ./_texture/path_to_the_north_texture
WE ./_texture/path_to_the_west_texture
EA					./_texture/path_to_the_east_texture
                                         
11111111111111
100000000000001
10000111111111111111111111
10000011000000000000010001
10000010000000000000000001
10000011000000000000010001
11100000011011111111110001
110000000000001      10001
100000000000001      10001
100000000000001      10001
10000000000000111111111111111111111
100000N0000000000000000000000000001
100000000000001000000000000000000011111
110000000000001001100000000000110010001
111111111111111111111111111111111111111