C 0,191,255
F 0,128,0

        SO	      			./texture/path_to_the_south_texture
NO ./texture/path_to_the_north_texture
WE ./texture/path_to_the_west_texture
EA					./texture/path_to_the_east_texture
                                         
111111111111111
1000000100000001
10000111111111111111111111
10N00011000000000000010001
10000010000000000000000001
10000011000000000000010001
11101111111011111111110001
110000110000001      10001
100000010000001      10001
100000010000001      10001
10000000000000111111111111111111111
10000001000000000000000000000000001
100000010000001000000000000000000011111
110000110000001001100000000000110010001
111111111111111111111111111111111111111